NO ./textures/wall.xpm
SO ./textures/wall2.xpm
WE ./textures/wall2.xpm
EA ./textures/wall2.xpm
C  173,206,237
F  174,128,92

DO	d fixed		0	./textures/door.xpm

1111111111111111111111111111111111111111
1E00000000000000000000000000000000000001
1000000000000000000000000000000000000001
1000000000000000000000000000000000000001
1000000000000000000000000000000000000001
1000000000000000000000000000000000000001
1000000000000000000100000000000000000001
1000000000000000000d00000000000000000001
1000000000000000000100000000000000000001
1000000000000000000000000000000000000001
1000000000000000000000000000000000000001
1000000000000000000000000000000000000001
1111111111111111111111111111111111111111