
NO	./textures/wall2.xpm
SO	./textures/wall2.xpm
WE	./textures/wall2.xpm
EA	./textures/wall2.xpm

C	173,206,237
F	174,128,92

        1111111111111111111111111
        1000000000110000000000001
        1011000001110001000000001
        1001000000000000000010101
111111111011000001110001000000001
100000000011000001110111111111111
11110111111111011100000010001
11110111111111011101000010001
11000000110101011100000000001
10000000000000001100000010001
10000000000000001101010000001
110000011101010111110111100N0111
11110111 1110101 100011010001
11111111 1111111 111111111111
