1111111111111
10010C00000C1
10000111110e1
1P0011E000001
1111111111111