1111111111111111111111111111111111
1P0000000000000C00000C00000e0000E1
1010010100100000101001000C000101e1
10100100101010100010010e0C00010101
100000000C00C00e00000000000000e0C1
1111111111111111111111111111111111